3,3,3,9,3,3,3,3,3,3,3,3,3,3
3,3,3,5,3,3,3,9,9,3,3,8,3,3
3,3,3,3,5,3,9,3,3,2,2,2,2,3
3,3,3,3,5,3,3,3,3,3,5,3,2,3
2,3,3,3,5,3,3,3,3,3,3,3,2,3
2,3,3,5,5,3,3,9,11,9,3,3,2,3
2,5,3,5,3,3,3,3,3,3,3,3,3,3
2,5,8,3,3,6,11,3,3,11,3,3,3,3
2,3,3,3,6,6,3,8,3,3,3,3,3,3
2,2,2,3,3,2,9,3,3,3,3,3,3,3
3,3,3,3,9,2,3,3,3,9,3,3,3,3
9,3,3,3,3,2,2,2,2,3,6,6,6,3
3,3,3,3,9,3,3,3,3,3,6,13,6,3
3,3,3,3,3,3,3,3,3,3,6,6,6,3

