1,1,1,1,1,1,10,1,1,1,1,1,1,1
1,1,1,1,1,1,10,1,1,9,1,9,9,1
9,1,3,8,2,5,10,1,2,2,1,1,9,1
1,1,3,1,2,1,10,1,1,1,1,1,9,1
1,1,3,2,2,1,10,1,1,11,2,1,1,1
1,6,3,2,1,1,1,1,1,1,2,1,2,2
1,2,12,3,1,1,6,1,1,3,3,1,2,2
1,1,2,2,1,2,1,1,1,1,1,3,9,1
1,1,1,1,2,10,10,9,9,2,1,3,1,1
9,9,9,1,2,10,1,1,9,1,1,3,11,1
1,1,9,1,5,10,2,1,1,11,9,3,1,1
12,1,9,1,2,10,2,1,1,9,1,3,1,9
1,1,9,2,2,10,1,9,1,1,7,7,1,2
1,1,1,1,1,10,1,1,1,1,1,1,1,1

