1,1,1,1,1,1,1,1,1,1,1,1,1,1
1,1,1,1,1,1,2,2,2,2,1,1,9,1
9,1,3,1,1,1,1,1,2,2,1,1,9,1
1,1,3,1,1,1,1,1,1,1,1,1,9,1
1,1,3,2,1,1,1,1,1,1,1,1,1,1
1,2,3,2,2,5,1,1,1,6,1,1,2,2
1,2,3,3,3,3,1,9,1,3,3,3,2,2
1,1,2,2,1,1,1,1,1,1,1,3,2,1
1,1,1,1,1,1,9,9,9,1,1,3,1,1
1,1,1,1,1,1,1,1,9,1,1,3,1,1
1,1,9,1,1,1,2,1,1,1,1,3,1,1
1,1,1,1,1,9,2,1,1,1,8,3,1,9
1,1,1,2,2,9,1,1,1,1,7,7,1,2
1,1,1,1,1,9,1,1,1,1,1,1,1,1

