1,1,1,1,1,1,1,1,1,1,1,1,1,1
1,1,1,1,9,1,1,1,1,7,1,1,14,1
1,1,1,1,1,5,1,1,5,7,1,1,1,1
9,1,1,1,1,1,1,1,1,1,1,1,1,1
1,1,5,8,8,1,1,1,1,9,1,1,5,1
1,1,1,1,1,1,1,1,11,1,1,1,1,1
1,1,9,1,1,1,1,5,1,11,1,1,1,1
1,1,1,1,7,1,1,1,1,1,1,7,7,1
1,1,5,1,7,1,1,1,1,1,1,1,1,1
1,1,1,1,1,1,11,5,1,9,1,1,1,1
1,1,1,9,1,1,1,1,1,1,1,1,1,1
1,7,1,1,1,1,1,1,1,1,5,1,1,9
1,7,1,1,5,1,8,8,1,1,1,1,1,1
1,1,1,1,1,1,1,1,1,1,1,1,1,1

